1111111
10C0001
10PC001
1000001
1000001
1M00001
1010111
10HCCE1
1111111