111111111
1M001M001
110111011
1M001M001
110111011
1M001M001
110111011
1PH000CE1
111111111