1111111
1000001
1000001
1000001
1000001
1M00001
1110111
1PH00E1
1111111