1111111111111111111111111
1111111111111111111111111
1111111111111111111111111
1111MMMMMMMMMMMMMMMMM1111
1111M11111111111111101111
1111M1E111C11C1M000101111
1111M1000000M010CC0101111
1111M11110111010CC0101111
1111M11M000M10P000M101111
1111M111101111H1111101111
1111M1C0000MC10100C101111
1111M10101010101101101111
1111M1CM0000C000000101111
1111011111111111111101111
1111000000000000000001111
1111111111111111111111111
1111111111111111111111111
1111111111111111111111111