1111111111111
1M000M1000001
1M100M0010001
1M000M0000001
1M000M0001001
1M000M0100001
11010M0000001
1111111111111
1E0000C0000P1
1111111111111