11111111111111111111111111111
10000000001000001000000000001
10000000001011101011111111111
1011111110101C101010000000001
10100000101010101010000000001
10101110101010101010000000001
10101110101010101110000000001
10100100101010100000000000001
10110101101010111111111111111
10100101101010011000M0000C1C1
101011011010110011C1110111101
10100101111011100111C00100001
1011010000001C110011110101111
10100111111110011000000000001
10101111100011001101111111101
11101111100001100101000000001
100000111011001100010C0101101
100E0000001110011101111101101
1000001111111100C0000000000P1
11111111111111111111111111111