111111111111111
1E111C11C1M0001
1000000M01PCC01
1111011101HCC01
11M000M100000M1
111101111011111
1C0000MC10100C1
101010101011011
1CM0000C0000001
111111111111111