111111111111111
1E111C11C1M0001
1000000M010CC01
11110111010CC01
11M0H0M100000M1
111101111011111
1C0000MC101PHC1
101010101011011
1CM0000C0000001
111111111111111