111111111111111
1E111C11C1M0001
1000000M010CC01
11110111010CC01
11M0C0M100000M1
111101111011111
1C0000MC101P0C1
101010101011011
1C00000C0000001
111111111111111