111111111111111
1E111C11C10M001
1000100M010CCM1
1110101101MCC01
1C0M00C10000M01
111111111011111
1C0000MC101P001
101010101011101
1CM0000C0000001
111111111111111