1111111111
101000M111
1110111111
1P0C0000E1
1111111111