1111111111
1000M00001
1C00E000P1
1000M00001
1111111111