11111111111
1C00MCM00C1
11101010111
10100000101
1000CCC0001
1P1000001E1
11111111111