1111111
1001001
1000001
1010101
100P001
1C111E1
1111111