1111
1C01
1E01
1001
1001
1P01
1111