1111111
10M0001
1000001
1000001
1000001
1110111
10HP001
1C111E1
1111111