1111111
10M1001
1000001
1010101
10HP001
1C111E1
1111111