111111111111111
1E11101101M0001
1000000M0100001
111101110100001
11M0H0M100000M1
111101111011111
100000M0101PHC1
101010101011011
10M000000000001
111111111111111