1111111
1000001
1000001
1000001
1000001
1M00001
1110111
1PH0CE1
1111111