11111
11E11
1MMM1
10M11
11001
1M0C1
10001
1MMM1
1MMM1
1CMM1
10001
1M001
1MMC1
100M1
1C001
1M001
10C01
10001
10P01
11111