1111111
1000001
1000001
1000001
1000001
1M00001
1110111
1PHCCE1
1111111