11111111111
1H000000001
1M111111101
10100000001
10101111101
1M101111101
10101111101
1M1C00010C1
10100100011
1M100000001
10000000001
1M000000101
10010000001
1M0000100C1
11100000111
10C00000C01
1E1000001P1
11111111111