111111111111111
111111MCM111111
11111M000M11111
1111M00000M1111
1PHC000C0000CE1
1111M00000M1111
11111M000M11111
111111MCM111111
111111111111111