1111111111111
11111E1110001
111MMCMM10101
11111011101M1
111M0C0M101M1
1111101110111
111M0C0M10111
1111101110111
1M11100000111
1M11111110111
1M1111111C111
1M00000000111
1111111110111
1MMM0P0000111
1111111111111