1111111
111E111
1110111
1MM0MM1
111C111
111P111
1111111