1111111
111E111
1110111
1C000C1
1000001
1110111
111P111
1111111