11111
11E11
1MMM1
1MMM1
1MMM1
1MMM1
1MMM1
1MMM1
1MMM1
1MMM1
1MMM1
1MMM1
1MMM1
1MMM1
1MMM1
1MMM1
1MMM1
11C11
11P11
11111