1111111
1P01001
1101011
1M00001
111C111
1M00001
111H111
1C000C1
1101011
1M010E1
1111111