1111111111111111111111111111111
1000000001111000000000001111111
1011111101111011111111101111111
10101001C1001011111111101110001
10101001010010111111100C0010101
1010111101111011111111101110101
10101000000010111111100000101E1
1010111101111011111111101110111
1010100000001011111110000010111
1010111101111011111111101110111
1010000000000011111011100000111
1011111111111111111011111110111
1011111100011111111011111110111
1011111000001111111000000000111
1011110000000111111111111110111
100000000000000C1P0000000000111
1111110000000111111111111111111
1111111000001111111111111111111
1111111100011111111111111111111
1111111111111111111111111111111