111111111111111
11P111111111E11
110111111111011
110111111111C11
100M1111111M001
110111111111011
110111111111011
110001111100011
111101111101111
111101111101111
1M00001110000M1
111011111110111
111011111110111
110011111110011
110111111111011
110111111111011
1000M11111M0001
110111111111011
110111111111011
1100000H0000011
111111111111111