11111
11E11
11011
1MMM1
10M11
11001
1M0C1
100M1
10001
1CMM1
10001
1M001
100C1
100M1
1C001
1M001
10C01
11H11
11P11
11111