11111
11E11
11011
100M1
10011
11001
100C1
1MMM1
10001
1C001
10001
10001
100C1
10001
1C001
10001
10001
11C11
11P11
11111