11111
11E11
11011
1MMM1
10M11
11001
1M0C1
1MMM1
1MMM1
1CMM1
10001
1M001
1MMC1
100M1
1C001
1M001
10001
11H11
11P11
11111