1111111111111
111111E111111
111111C111111
10M00M00M00M1
1011111111101
1M11111111101
100M00M00M001
111111C111111
1M0000M000CC1
11111111111C1
11M000M000M01
111C111111111
111M0000M0111
111111C111111
11110000M1111
111111H111111
111111P111111
1111111111111