1111111111111
1M1MM1E1MM1M1
1M1MM101MM1M1
1M111101111M1
1M1MMMCMMM1M1
1M111101111M1
1M1MMMCMMM1M1
1011110111101
1CM0M0H0000P1
1111111111111